12, 12, 12, 12, 12, 12, 12, 12, 12, 12
5,0,4,0,0,0,0,0,4,12
0,0,0,0,2,0,0,0,0,5
2,0,0,0,0,0,12,0,0,0
2,2,0,0,22,5,0,0,4,0
0,2,0,0,5,0,5,0,0,0
0,5,0,4,2,0,0,0,0,5
0,0,0,12,0,0,0,4,0,12
12,5,0,0,0,0,0,0,0,0
0,0,0,4,4,4,12,0,0,0