0,0,0,0,0,0,0,0,0,0
0,0,12,2,0,0,0,0,0,0
0,0,12,2,0,0,0,0,0,0
0,0,12,2,0,0,0,0,0,0
0,0,12,0,0,0,5,0,0,0
0,0,12,0,0,5,0,0,0,0
0,0,12,0,0,5,0,0,0,0
0,0,0,0,0,0,0,2,12,0
0,0,0,0,0,0,0,2,12,0
0,0,0,0,0,0,0,2,12,0