12, 12, 12, 12, 12, 12, 12, 12, 12, 12
0,0,0,0,0,0,5,5,4,12
0,12,12,0,2,0,0,0,0,5
2,0,0,0,0,0,12,0,0,0
2,2,0,0,20,0,0,0,5,0,
0,2,5,0,0,0,0,0,0,0
0,5,0,0,2,0,5,0,0,0
0,0,0,0,0,0,0,4,4,12
0,0,0,4,0,0,5,0,0,5
0,0,0,0,0,4,12,0,0,0