0,12,0,4,2,0,0,0,0,0
0,0,0,5,12,12,0,0,4,0
12,0,4,0,0,4,4,5,4,2
0,0,0,0,0,0,0,0,0,4
0,0,5,5,0,0,12,4,4,0
0,0,0,0,0,0,4,0,0,0
0,0,0,0,0,0,4,0,0,0
5,0,0,0,0,0,0,0,0,12
0,2,0,12,0,0,0,12,0,0
0,0,0,0,0,12,12,20,12,12