0,0,0,0,0,0,0,0,0,0
0,0,0,0,0,0,0,11,0,0
0,0,0,0,0,0,0,0,0,0
0,0,0,0,0,0,0,2,0,12
12,2,0,0,0,0,0,2,0,12
12,2,0,0,11,0,0,2,0,12
12,2,2,0,0,0,0,2,0,12
0,0,0,0,0,5,2,0,0,12
0,0,11,0,0,5,2,0,0,12
0,0,0,0,2,0,2,0,0,12