2,2,2,2,0,2,2,2,2,2
0,0,0,5,4,0,0,0,4,12
2,2,2,2,4,2,2,0,0,12
0,0,0,0,0,0,0,0,0,0
11,0,2,2,0,2,2,2,0,2
0,0,4,0,0,0,0,0,0,12
2,2,4,0,4,2,2,2,0,0
12,0,0,0,0,5,0,0,4,0,
0,0,0,2,4,2,2,2,2,2
12,0,0,0,4,0,5,0,0,0