0,13,4,0,0,0,0,0,0,0
0,0,0,0,0,0,4,5,15,0
5,0,0,5,0,0,4,0,13,4
13,0,0,0,0,0,4,0,0,0
0,0,0,0,0,13,15,0,0,13
13,5,0,0,13,0,15,0,0,0
0,0,0,13,0,0,0,0,15,0
0,0,0,0,0,0,0,0,0,0
13,0,0,0,0,15,0,0,0,0
0,13,0,0,0,0,0,13,0,0