15,15,15,15,15,15,15,15,15,15
0,5,5,0,24,14,0,5,0,0
12,0,4,5,0,0,15,5,0,0
5,0,4,15,5,0,0,0,0,14
12,0,4,0,0,0,15,12,0,0
0,0,0,15,5,5,5,4,4,12
12,0,0,0,0,0,15,5,0,0
0,5,5,15,5,5,5,4,4,12
12,4,4,0,4,0,15,5,4,5
0,4,0,15,0,0,5,0,4,12