0,0,0,0,0,0,0,0,2,0
5,0,0,0,0,0,0,11,0,0
0,0,0,14,0,0,0,2,0,0
0,0,0,0,0,0,0,0,0,2
0,0,5,0,0,0,0,0,5,0
0,0,14,0,14,0,0,0,0,0
0,0,0,0,14,0,0,0,0,0
0,0,0,0,0,2,0,0,0,0
0,0,0,0,2,0,0,0,0,0
0,0,0,0,0,0,0,0,0,0