0,4,4,0,0,0,0,0,0,0
5,0,0,0,0,0,0,0,15,0
0,0,0,0,0,0,0,14,0,0
0,0,0,0,0,0,0,0,0,0
0,0,0,0,0,0,15,5,0,0
0,0,14,0,0,0,0,0,0,0
0,0,0,5,14,0,14,0,0,0
0,0,0,0,0,0,0,0,0,0
0,0,0,0,0,0,0,0,4,0
0,0,0,0,0,0,0,0,14,0