2,2,2,2,2,2,2,2,2,2
0,5,5,0,24,14,0,5,0,0
12,0,4,5,0,0,2,5,0,0
5,0,4,2,5,0,0,0,0,14
12,0,4,0,0,0,2,12,0,0
0,0,0,2,5,5,5,4,4,12
12,0,0,0,0,0,2,5,0,0
0,5,5,2,5,5,5,4,4,12
12,4,4,0,4,0,2,5,4,5
0,4,0,2,0,0,5,0,4,12