-1, -1, -1,1,8,1, -1, -1, -1, -1
-1, -1, -1,1,0,1, -1, -1, -1, -1
-1, -1, -1,0,0,1, -1, -1, -1, -1
-1, -1, -1,1,0,1, -1, -1, -1, -1
-1, -1, -1,1,0,1, -1, -1, -1, -1
-1, -1, -1,1,0,1, -1, -1, -1, -1
-1, -1, -1,1,0,1, -1, -1, -1, -1
-1, -1, -1,1,0,1, -1, -1, -1, -1
-1, -1, -1,1,0,1, -1, -1, -1, -1
-1, -1, -1,1,7,1, -1, -1, -1, -1