0,0,0,0,8,0,0,0,0,12
0,0,0,0,0,0,0,0,0,0
0,0,0,0,0,0,11,0,0,0
0,0,0,0,2,2,0,0,0,0
0,0,0,0,2,20,0,0,0,12
12,0,0,0,11,0,5,4,4,0
0,0,2,0,0,0,0,0,5,0
2,0,0,2,0,0,0,0,0,0
12,5,4,0,2,2,2,2,2,0
12,0,0,0,0,7,0,0,0,0