12, 12, 12, 12, 12, 12, 12, 12, 12, 12
0,4,4,0,0,0,4,5,0,0
0,0,0,0,2,2,0,0,0,5
0,0,0,0,0,0,0,0,0,0,
0,0,0,0,0,0,0,11,0,0,
2,0,0,0,2,5,0,0,0,0
0,0,0,0,0,0,2,0,0,0,
0,0,0,0,0,0,2,0,0,0,
0,0,0,0,0,0,2,0,0,0,
0,0,0,0,0,0,2,0,0,0,