0,13,4,0,0,0,0,0,0,0
0,0,0,0,0,0,4,5,2,0
5,0,0,5,0,0,4,0,13,4
13,0,0,0,0,0,4,0,0,0
0,0,0,0,0,13,2,0,0,13
13,5,0,0,13,0,2,0,0,0
0,0,0,13,0,0,0,0,2,0
0,0,0,0,0,0,0,0,0,0
13,0,0,0,0,2,0,0,0,0
0,13,0,0,0,0,0,13,0,0