13,13,13,13,13,13,13,13,13,13
13,0,0,0,0,0,4,0,2,13
13,0,0,0,0,0,0,0,0,13
13,0,0,0,23,0,0,0,0,13
13,0,0,0,0,0,0,0,0,13
13,0,0,0,0,0,0,0,0,13
13,0,0,0,0,0,0,0,0,13
13,0,0,0,0,0,0,0,0,13
13,2,0,0,0,0,0,0,0,13
13,13,13,13,13,13,13,13,13,13