12, 12, 12, 12, 12, 12, 12, 12, 12, 12
0,0,0,0,0,5,0,0,0,0
0,0,2,0,0,0,5,0,0,0
0,0,0,0,2,2,0,0,0,0
2,0,0,0,2,2,2,0,0,0
0,0,0,0,2,0,2,0,11,0
0,0,2,5,0,5,0,0,0,0
0,4,2,0,0,0,0,0,0,0
0,0,2,0,0,0,0,0,0,0
0,0,2,0,0,0,0,0,0,0