0,0,0,0,0,0,0,0,0,0
0,13,0,2,2,2,0,0,0,0
0,0,0,0,0,13,2,0,0,0
0,0,2,0,0,0,13,13,0,0
0,0,0,0,13,0,2,0,2,0
0,2,13,0,0,0,2,0,0,2,
0,0,0,0,0,13,0,0,0,0
0,0,0,0,2,0,0,0,13,0
13,13,0,0,0,0,0,2,0,0,
0,0,0,13,0,0,0,0,0,0