0,0,0,0,0,0,0,0,0,0
0,0,0,12,0,12,0,0,0,0
0,0,0,0,5,12,0,0,0,0
0,0,0,12,0,12,0,0,0,0
0,0,0,12,0,12,0,0,0,0
0,0,0,12,0,12,0,0,0,0
0,0,0,12,0,12,0,0,0,0
0,0,0,12,0,12,0,0,0,0
0,0,0,12,0,12,0,0,0,0
0,0,0,12,0,12,0,0,0,0