0,0,0,0,0,0,0,0,0,0
0,0,0,12,0,0,0,0,0,0
0,0,0,12,5,0,0,0,0,0
0,0,0,12,0,0,0,0,0,0
0,0,0,0,0,0,12,0,0,0
0,0,0,0,0,5,12,0,0,0
0,0,0,0,0,0,12,0,0,0
0,0,0,12,5,0,0,0,0,0
0,0,0,12,5,4,0,0,0,0
0,0,0,12,0,0,0,0,0,0